#--------------------#
|                    |
| <'            >'   |
| ''            ''   |
|                    |
|                    |
|          P         |
|                    |
|                    |
|  e             e   |
|                    |
#--------------------#
